05. Albert Ammons - Swanee River Boogie | 05. Albert Ammons - Swanee River Boogie
08. Clarence 'Pine Top' Smith - Pinetop's Boogie Woogie | 08. Clarence 'Pine Top' Smith - Pinetop's Boogie Woogie
09. Jimmy Yancey, Meade Lux Lewis - Yancey Special | 09. Jimmy Yancey, Meade Lux Lewis - Yancey Special
101 Hits for Buskers - Book 02 | 101 Hits for Buskers - Book 02
150 American Jazz Standards (Russian) | 150 American Jazz Standards (Russian)
20s 30s fakebook | 20s 30s fakebook
Aebersold - The Jazz Handbook | Aebersold - The Jazz Handbook
Amčlie_Soundtrack_YannTiersen | Amčlie_Soundtrack_YannTiersen
Annie - Full Score | Annie - Full Score
B.B. King - Blues Master I [book] | B.B. King - Blues Master I [book]
Beatles - All Songs 1962-1974 | Beatles - All Songs 1962-1974
Beauty and the Beast (Piano Conductor's Score) | Beauty and the Beast (Piano Conductor's Score)
Bernstein - On the Town (Piano Conductor Score) | Bernstein - On the Town (Piano Conductor Score)
Billy Joel - Keyboard Book | Billy Joel - Keyboard Book
Blood Brothers (Book) | Blood Brothers (Book)
Bossa Nova (Bb) | Bossa Nova (Bb)
Bossa Nova Fakebook | Bossa Nova Fakebook
Bugsy Malone - Piano Vocal Score | Bugsy Malone - Piano Vocal Score
Cabaret (Original) | Cabaret (Original)
Cats Book | Cats Book
Charlie Parker - Essential Jazz Lines in the style of | Charlie Parker - Essential Jazz Lines in the style of
ChicagoBook | ChicagoBook
Christmas Real Book | Christmas Real Book
Collection of Golden Standards | Collection of Golden Standards
Dixieland Fake Book Vol 1 | Dixieland Fake Book Vol 1
Dixieland Fakebook Vol. 2 | Dixieland Fakebook Vol. 2
Dixieland Jazz Standards Book 1 | Dixieland Jazz Standards Book 1
Doobie Brothers Guitar Anthology | Doobie Brothers Guitar Anthology
Elvis Presley - The compleat (piano guitar chord songbook) | Elvis Presley - The compleat (piano guitar chord songbook)
Fakebook - Volume I of Over 1000 Songs | Fakebook - Volume I of Over 1000 Songs
Fakebook of Swing Jazz | Fakebook of Swing Jazz
Fats Waller - For Piano | Fats Waller - For Piano
Fats Waller - The Music Makers | Fats Waller - The Music Makers
Gary Moore - Still got the blues-songbook | Gary Moore - Still got the blues-songbook
George Gershwin - The Greatest Songs of George Gershwin | George Gershwin - The Greatest Songs of George Gershwin
George Harrison - The Dark Horse Years 1976-1992 Songbook | George Harrison - The Dark Horse Years 1976-1992 Songbook
Great American Music Broadway Musicals | Great American Music Broadway Musicals
Into the Woods | Into the Woods
Irving Berlin Fake Book | Irving Berlin Fake Book
Jazz standards (Budget books) | Jazz standards (Budget books)
John Coltrane - Improvised Saxophone Solos | John Coltrane - Improvised Saxophone Solos
John Coltrane Solos | John Coltrane Solos
John Williams - Star Wars Episode III - Revenge Of The Sith (book) | John Williams - Star Wars Episode III - Revenge Of The Sith (book)
Keith Jarrett - The Koln Concert - Piano Transcription | Keith Jarrett - The Koln Concert - Piano Transcription
Kiss Me Kate | Kiss Me Kate
Lippa - Wild Party (pf score) | Lippa - Wild Party (pf score)
Little Shop of Horrors | Little Shop of Horrors
Miles Davis - Kind Of Blue | Miles Davis - Kind Of Blue
Miles Davis Real Book | Miles Davis Real Book
Monster Jazz Fake Book Vol 1 | Monster Jazz Fake Book Vol 1
Nat King Cole - Unforgettable | Nat King Cole - Unforgettable
New Orleans Jam Book | New Orleans Jam Book
Oliver (CM Revival) | Oliver (CM Revival)
Oscar Peterson - Artist Transcriptions - Hal Leonard | Oscar Peterson - Artist Transcriptions - Hal Leonard
Paul Simon - Anthology | Paul Simon - Anthology
Pink Floyd - Dark Side of the Moon | Pink Floyd - Dark Side of the Moon
Real Book Vol 4 (Hal Leonard) | Real Book Vol 4 (Hal Leonard)
Real Book Vol 5 (Hal Leonard) | Real Book Vol 5 (Hal Leonard)
Real Vocal Book | Real Vocal Book
Red Hot Chili Peppers - Californication | Red Hot Chili Peppers - Californication
Rent - Songbook | Rent - Songbook
Samba Fakebook | Samba Fakebook
Satie_-_Choses_vues_%C3%A0_droite_et_%C3%A0_gauche_%28violin_and_piano%29 | Satie_-_Choses_vues_%C3%A0_droite_et_%C3%A0_gauche_%28violin_and_piano%29
Satie_-_Trois_Gymnopedies_%28typeset%29 | Satie_-_Trois_Gymnopedies_%28typeset%29
Sondheim - Sunday in the Park with George | Sondheim - Sunday in the Park with George
Spaces I - Jazz Classics | Spaces I - Jazz Classics
Spaces IV - Compendium of Jazz Tastes | Spaces IV - Compendium of Jazz Tastes
Spaces VI - Jazz Solos | Spaces VI - Jazz Solos
Spamalot | Spamalot
Spirited Away | Spirited Away
Sting - Fields of Gold - The Best Songbook | Sting - Fields of Gold - The Best Songbook
TV Fakebook (Hal Leonard) | TV Fakebook (Hal Leonard)
The Beatles - Complete Scores | The Beatles - Complete Scores
The Best of Steely Dan | The Best of Steely Dan
The John Lennon Collection (grab it) | The John Lennon Collection (grab it)
The Who - The Who Anthology | The Who - The Who Anthology
U2 - The Sweetest Thing | U2 - The Sweetest Thing
Ultimate Online Fake Book, B-Flat Ed | Ultimate Online Fake Book, B-Flat Ed
Unknown - 1467 sheets | Unknown - 1467 sheets
Unknown - 200 pgs - Jazz & Standards | Unknown - 200 pgs - Jazz & Standards
Vol 111 - JJ Johnson | Vol 111 - JJ Johnson
Whistle down the wind-Andrew Lloyd Webber | Whistle down the wind-Andrew Lloyd Webber
Wicked (Full Book) | Wicked (Full Book)
Wicked Part 1 | Wicked Part 1
Wicked Part 2 | Wicked Part 2
World Hits of Jazz Standard | World Hits of Jazz Standard
high school musical full book | high school musical full book
