05. Albert Ammons - Swanee River Boogie | Anthologies - Jazz/Boogie Woogie Piano Sheet Music - 12 Old Pieces + Bonus piece/Musik - pdf/05. Albert Ammons - Swanee River Boogie.pdf
08. Clarence 'Pine Top' Smith - Pinetop's Boogie Woogie | Anthologies - Jazz/Boogie Woogie Piano Sheet Music - 12 Old Pieces + Bonus piece/Musik - pdf/08. Clarence 'Pine Top' Smith - Pinetop's Boogie Woogie.pdf
09. Jimmy Yancey, Meade Lux Lewis - Yancey Special | Anthologies - Jazz/Boogie Woogie Piano Sheet Music - 12 Old Pieces + Bonus piece/Musik - pdf/09. Jimmy Yancey, Meade Lux Lewis - Yancey Special.pdf
101 Hits for Buskers - Book 02 | Fake Books/101 Hits for Buskers - Book 02.pdf
150 American Jazz Standards (Russian) | Fake Books/150 American Jazz Standards (Russian).pdf
20s 30s fakebook | Fake Books/20s 30s fakebook.pdf
Aebersold - The Jazz Handbook | Aebersold/Aebersold - The Jazz Handbook.pdf
Amčlie_Soundtrack_YannTiersen | Film/Amčlie_Soundtrack_YannTiersen.pdf
Annie - Full Score | Broadway/Annie - Full Score.pdf
B.B. King - Blues Master I [book] | Anthologies - Jazz/B.B. King - Blues Master I [book].pdf
Beatles - All Songs 1962-1974 | Anthologies - Pop, Rock/Beatles - All Songs 1962-1974.pdf
Beauty and the Beast (Piano Conductor's Score) | Broadway/Beauty and the Beast/Beauty and the Beast (Piano Conductor's Score).pdf
Bernstein - On the Town (Piano Conductor Score) | Broadway/Bernstein - On the Town (Piano Conductor Score).pdf
Billy Joel - Keyboard Book | Anthologies - Pop, Rock/Billy Joel - Keyboard Book.pdf
Blood Brothers (Book) | Film/Blood Brothers (Book).pdf
Bossa Nova (Bb) | Anthologies - Jazz/Bossa Nova (Bb).pdf
Bossa Nova Fakebook | Fake Books/Bossa Nova Fakebook.pdf
Bugsy Malone - Piano Vocal Score | Broadway/Bugsy Malone - Piano Vocal Score.pdf
Cabaret (Original) | Broadway/Cabaret (Original).pdf
Cats Book | Broadway/Cats/Cats Book.pdf
Charlie Parker - Essential Jazz Lines in the style of | Anthologies - Jazz/Charlie Parker - Essential Jazz Lines in the style of.pdf
ChicagoBook | Broadway/Chicago/ChicagoBook.pdf
Christmas Real Book | Fake Books/Christmas Real Book.pdf
Collection of Golden Standards | Fake Books/Collection of Golden Standards.pdf
Dixieland Fake Book Vol 1 | Fake Books/Dixieland Fake Book Vol 1.pdf
Dixieland Fakebook Vol. 2 | Fake Books/Dixieland Fakebook Vol. 2.pdf
Dixieland Jazz Standards Book 1 | Fake Books/Dixieland Jazz Standards Book 1.pdf
Doobie Brothers Guitar Anthology | Anthologies - Pop, Rock/Doobie Brothers Guitar Anthology.pdf
Elvis Presley - The compleat (piano guitar chord songbook) | Anthologies - Pop, Rock/Elvis Presley - The compleat (piano guitar chord songbook).pdf
Fakebook - Volume I of Over 1000 Songs | Fake Books/Fakebook - Volume I of Over 1000 Songs.pdf
Fakebook of Swing Jazz | Fake Books/Fakebook of Swing Jazz.pdf
Fats Waller - For Piano | Anthologies - Jazz/Fats Waller - For Piano.pdf
Fats Waller - The Music Makers | Anthologies - Jazz/Fats Waller - The Music Makers.pdf
Gary Moore - Still got the blues-songbook | Anthologies - Jazz/Gary Moore - Still got the blues-songbook.pdf
George Gershwin - The Greatest Songs of George Gershwin | Anthologies - Jazz/George Gershwin - The Greatest Songs of George Gershwin.pdf
George Harrison - The Dark Horse Years 1976-1992 Songbook | Anthologies - Pop, Rock/George Harrison - The Dark Horse Years 1976-1992 Songbook.pdf
Great American Music Broadway Musicals | Broadway/Great American Music Broadway Musicals.pdf
Into the Woods | Film/Into the Woods.pdf
Irving Berlin Fake Book | Anthologies - Jazz/Irving Berlin Fake Book.pdf
Jazz standards (Budget books) | Fake Books/Jazz standards (Budget books).pdf
John Coltrane - Improvised Saxophone Solos | Anthologies - Jazz/John Coltrane - Improvised Saxophone Solos.pdf
John Coltrane Solos | Anthologies - Jazz/John Coltrane Solos.pdf
John Williams - Star Wars Episode III - Revenge Of The Sith (book) | Film/John Williams - Star Wars Episode III - Revenge Of The Sith (book).pdf
Keith Jarrett - The Koln Concert - Piano Transcription | Anthologies - Jazz/Keith Jarrett/Keith Jarrett - The Koln Concert - Piano Transcription.pdf
Kiss Me Kate | Film/Kiss Me Kate.pdf
Lippa - Wild Party (pf score) | Broadway/Lippa - Wild Party (pf score).pdf
Little Shop of Horrors | Broadway/Little Shop of Horrors/Little Shop of Horrors.pdf
Miles Davis - Kind Of Blue | Anthologies - Jazz/Miles Davis - Kind Of Blue.pdf
Miles Davis Real Book | Anthologies - Jazz/Miles Davis Real Book.pdf
Monster Jazz Fake Book Vol 1 | Fake Books/Monster Jazz Fake Book Vol 1.pdf
Nat King Cole - Unforgettable | Anthologies - Jazz/Nat King Cole - Unforgettable.pdf
New Orleans Jam Book | Fake Books/New Orleans Jam Book.pdf
Oliver (CM Revival) | Broadway/Oliver (CM Revival).pdf
Oscar Peterson - Artist Transcriptions - Hal Leonard | Anthologies - Jazz/Oscar Peterson - Artist Transcriptions - Hal Leonard.pdf
Paul Simon - Anthology | Anthologies - Pop, Rock/Paul Simon - Anthology.pdf
Pink Floyd - Dark Side of the Moon | Anthologies - Pop, Rock/Pink Floyd - Dark Side of the Moon.pdf
Real Book Vol 4 (Hal Leonard) | Fake Books/Real Book Vol 4 (Hal Leonard).pdf
Real Book Vol 5 (Hal Leonard) | Fake Books/Real Book Vol 5 (Hal Leonard).pdf
Real Vocal Book | Fake Books/Real Vocal Book.pdf
Red Hot Chili Peppers - Californication | Anthologies - Pop, Rock/Red Hot Chili Peppers - Californication.pdf
Rent - Songbook | Film/Rent - Songbook.pdf
Samba Fakebook | Fake Books/Samba Fakebook.pdf
Satie_-_Choses_vues_%C3%A0_droite_et_%C3%A0_gauche_%28violin_and_piano%29 | Classical/Erik Satie Complete Sheet Music PDF/Satie_-_Choses_vues_%C3%A0_droite_et_%C3%A0_gauche_%28violin_and_piano%29.pdf
Satie_-_Trois_Gymnopedies_%28typeset%29 | Classical/Erik Satie Complete Sheet Music PDF/Satie_-_Trois_Gymnopedies_%28typeset%29.pdf
Sondheim - Sunday in the Park with George | Broadway/Sondheim - Sunday in the Park with George.pdf
Spaces I - Jazz Classics | Fake Books/Spaces I - Jazz Classics.pdf
Spaces IV - Compendium of Jazz Tastes | Fake Books/Spaces IV - Compendium of Jazz Tastes.pdf
Spaces VI - Jazz Solos | Fake Books/Spaces VI - Jazz Solos.pdf
Spamalot | Broadway/Monty Python's Spamalot!/Spamalot.pdf
Spirited Away | Film/Spirited Away.pdf
Sting - Fields of Gold - The Best Songbook | Anthologies - Pop, Rock/Sting - Fields of Gold - The Best Songbook.pdf
TV Fakebook (Hal Leonard) | Fake Books/TV Fakebook (Hal Leonard).pdf
The Beatles - Complete Scores | Anthologies - Pop, Rock/The Beatles - Complete Scores.pdf
The Best of Steely Dan | Anthologies - Pop, Rock/The Best of Steely Dan.pdf
The John Lennon Collection (grab it) | Anthologies - Pop, Rock/The John Lennon Collection (grab it).pdf
The Who - The Who Anthology | Anthologies - Pop, Rock/The Who - The Who Anthology.pdf
U2 - The Sweetest Thing | Sheet Music/Pdf/U2 - The Sweetest Thing.pdf
Ultimate Online Fake Book, B-Flat Ed | Fake Books/Ultimate Online Fake Book, B-Flat Ed.pdf
Unknown - 1467 sheets | Fake Books/Unknown - 1467 sheets.pdf
Unknown - 200 pgs - Jazz & Standards | Fake Books/Unknown - 200 pgs - Jazz & Standards.pdf
Vol 111 - JJ Johnson | Aebersold/Vol 111 - JJ Johnson.pdf
Whistle down the wind-Andrew Lloyd Webber | Film/Whistle down the wind-Andrew Lloyd Webber.pdf
Wicked (Full Book) | Broadway/Wicked/Wicked (Full Book).pdf
Wicked Part 1 | Film/Wicked Part 1.pdf
Wicked Part 2 | Film/Wicked Part 2.pdf
World Hits of Jazz Standard | Fake Books/World Hits of Jazz Standard.pdf
high school musical full book | Broadway/high school musical full book.pdf
