Divertamento | Divertimento                         |New Real Book Vol 3 - Chuck Sher
Always There (Laws & Jeffrey) | Always There        |New Real Book Vol 1 - Chuck Sher
Baby I Love You | Baby, I Love You                  |New Real Book Vol 1 - Chuck Sher
Anamaria | Ana Maria                                |New Real Book Vol 1 - Chuck Sher
Bird Food (Coleman) | Bird Food                     |New Real Book Vol 1 - Chuck Sher
Blues Connotation (Coleman) | Blues Connotation     |New Real Book Vol 1 - Chuck Sher
Bouncing With Bud | Bouncin' With Bud               |New Real Book Vol 1 - Chuck Sher
Ay Arriba! | Ay, Arriba!                            |Real Book Vol 1 - Orig  
Ay, Arriba | Ay, Arriba!                            |Real Book Vol 1 - Orig  
Change Of Mind (Mintzer) | Change Of Mind | New Real Book Vol 1 - Chuck Sher
Chega De Saudade | Chega De Saudade (No More Blues) | New Real Book Vol 1 - Chuck Sher
Creek (Brasil) | Creek | New Real Book Vol 1 - Chuck Sher
Crystal Love (Ozone) | Crystal Love | New Real Book Vol 1 - Chuck Sher
Do Nothin' Till You Hear From Me | Do Nothing 'Til You Hear From Me | New Real Book Vol 1 - Chuck Sher
Do Nothing Till You Hear From Me | Do Nothing 'Til You Hear From Me | New Real Book Vol 1 - Chuck Sher
Doors (Nock) | Doors | New Real Book Vol 1 - Chuck Sher
E. S. P. | E.S.P. | New Real Book Vol 1 - Chuck Sher
Elm (Beirach) | Elm | New Real Book Vol 1 - Chuck Sher
Goin' Home (Ferrante) | Goin' Home | New Real Book Vol 1 - Chuck Sher
P.Y.T.(Pretty Young Thing) | P.Y.T. (Pretty Young Thing) | New Real Book Vol 1 - Chuck Sher
Who Can I Turn To? | Who Can I Turn To | New Real Book Vol 1 - Chuck Sher
Young Rabbits (Henderson) | Young Rabbits | New Real Book Vol 1 - Chuck Sher
Waterwings (Grusin) | Waterwings | New Real Book Vol 1 - Chuck Sher
Waltz For Debbie | Waltz For Debby | New Real Book Vol 1 - Chuck Sher
Velas (Velas Icadas) | Velas | New Real Book Vol 1 - Chuck Sher
Unit 7 | Unit Seven | New Real Book Vol 1 - Chuck Sher
Take The A Train | Take The "A" Train | New Real Book Vol 1 - Chuck Sher
Sunrunner (James) | Sunrunner | New Real Book Vol 1 - Chuck Sher
Soul Sauce (Guarachi Guaro) | Soul Sauce (Wachi Wara) | New Real Book Vol 1 - Chuck Sher
Soul Sauce (Guarachi Guaro) | Soul Sauce | New Real Book Vol 1 - Chuck Sher
Soul Sauce (Wachi Wara) | Soul Sauce | New Real Book Vol 1 - Chuck Sher
Sonja's Sanfona (Haslip) | Sonja's Sanfona | New Real Book Vol 1 - Chuck Sher
Some Day My Prince Will Come | Someday My Prince Will Come | New Real Book Vol 1 - Chuck Sher
Shawnuff | Shaw 'Nuff | New Real Book Vol 1 - Chuck Sher
Self-Portrait In Three Colors | Self Portrait In Three Colors | New Real Book Vol 1 - Chuck Sher
Ruby My Dear | Ruby, My Dear | New Real Book Vol 1 - Chuck Sher
Robbins Nest | Robbin's Nest | New Real Book Vol 1 - Chuck Sher
'Long A You Know You're Living Yours | 'Long As You Know You're Living Yours | Real Book Vol 1 - Orig
12-4 2-4/Duplicities | 12-4 2-4 / Duplicities | Real Book Vol 1 - Orig
Call For All Demons | A Call For All Demons | Real Book Vol 1 - Orig
Child Is Born | A Child Is Born | Real Book Vol 1 - Orig
Family Joy | A Family Joy | Real Book Vol 1 - Orig
Fine Romance | A Fine Romance | Real Book Vol 1 - Orig
Foggy Day | A Foggy Day | Real Book Vol 1 - Orig
And Now The Queen | And Now, The Queen | Real Book Vol 1 - Orig
Arise Her Eyes | Arise, Her Eyes | Real Book Vol 1 - Orig
Beauty And The Blast | Beauty And The Beast | Real Book Vol 1 - Orig
Blesses Relief | Blessed Relief | Real Book Vol 1 - Orig
Blue Train | Blue Trane | Real Book Vol 1 - Orig
Bluesettes | Bluesette | Real Book Vol 1 - Orig
Chega De Suadade (No More Blues) | Chega De Saudade (No More Blues) | Real Book Vol 1 - Orig
Come Sun Day | Come Sunday | Real Book Vol 1 - Orig
Corcovada (Quite Nights) | Corcovado | Real Book Vol 1 - Orig
De Pois De Amor O Vazio | De Pois Do Amor O Vazio | Real Book Vol 1 - Orig
De Pois De Amor O'vazio | De Pois Do Amor O Vazio | Real Book Vol 1 - Orig
Dear Old Stockholm (Ack Varmeland) | Dear Old Stockholm | Real Book Vol 1 - Orig
Doin The Pig | Doin' The Pig | Real Book Vol 1 - Orig
Eighty One | Eighty-One | Real Book Vol 1 - Orig
For Heavens Sake | For Heaven's Sake | Real Book Vol 1 - Orig
Good Evening Mr. And Mrs. America | Good Evening Mr. & Mrs. America | Real Book Vol 1 - Orig
Good Evening Mr. And Mrs.America | Good Evening Mr. & Mrs. America | Real Book Vol 1 - Orig
Goodbye Porkpie Hat | Goodbye Pork Pie Hat | Real Book Vol 1 - Orig
Green Dolphin St. | Green Dolphin Street | Real Book Vol 1 - Orig
Hello Young Lovers | Hello, Young Lovers | Real Book Vol 1 - Orig
Henninger Flats | Henniger Flats | Real Book Vol 1 - Orig
How Sweet My Heart Sings | How My Heart Sings | Real Book Vol 1 - Orig
I Let A Song Go Out Of My Heart | I Let A Song (Go Out Of My Heart) | Real Book Vol 1 - Orig
Isn't It Romantic | Isn't It Romantic? | Real Book Vol 1 - Orig
It Don't Mean A Thing (If It Ain't Got That Swing) | It Don't Mean A Thing | Real Book Vol 1 - Orig
June 15 1967 | June 15, 1967 | Real Book Vol 1 - Orig
June 15Th 1967 | June 15, 1967 | Real Book Vol 1 - Orig
Lazy Bird | Lazybird | Real Book Vol 1 - Orig
Leroy The Magician | Leroy, The Magician | Real Book Vol 1 - Orig
Majoong | Mahjong | Real Book Vol 1 - Orig
Midwestern Night's Dream (Untitled) | Midwestern Nights Dream | Real Book Vol 1 - Orig
Mr. Pc | Mr. P.C. | Real Book Vol 1 - Orig
Nostalgia In Times Sqaure | Nostalgia In Times Square | Real Book Vol 1 - Orig
Olinoqui Valley | Olinoqui Vally | Real Book Vol 1 - Orig
On Green Dolphin Street | Green Dolphin Street | Real Book Vol 1 - Orig
Open Your Eyes You Can Fly | Open Your Eyes, You Can Fly | Real Book Vol 1 - Orig
Pent Up House | Pent-Up House | Real Book Vol 1 - Orig
Perfect Love Jamala | Perfect Love | Real Book Vol 1 - Orig
Pfrancing | Pfrancing (No Blues) | Real Book Vol 1 - Orig
Pithycampus Erectus | Pithycanthropus Erectus | Real Book Vol 1 - Orig
Portsmouth Configurations | Portsmouth Figurations | Real Book Vol 1 - Orig
Reincarnation Of A Lovebird | Re-Incarnation Of A Lovebird | Real Book Vol 1 - Orig
Saga Of Harrison Crabpeathers | Saga Of Harrison Crabfeathers | Real Book Vol 1 - Orig
Self Portrait In Three Colors | Self Portrait In 3 Colors | Real Book Vol 1 - Orig
Serenade To Cuckoo | Serenade To A Cuckoo | Real Book Vol 1 - Orig
Slowly Gone Bygone | Slowly Gone, Bygone | Real Book Vol 1 - Orig
Slowly Gone Bygone | Slowly Gone, Bygone | Real Book Vol 1 - Orig
Slowly, Gone | Slowly Gone, Bygone | Real Book Vol 1 - Orig
Space Circus (Part 1) | Space Circus (Part I) | Real Book Vol 1 - Orig
Space Circus Part 1 | Space Circus (Part I) | Real Book Vol 1 - Orig
Space Circus (Part 2) | Space Circus (Part Ii) | Real Book Vol 1 - Orig
Space Circus Part 2 | Space Circus (Part Ii) | Real Book Vol 1 - Orig
Speack No Evil | Speak No Evil | Real Book Vol 1 - Orig
Straight No Chaser | Straight, No Chaser | Real Book Vol 1 - Orig
Swedish Patry | Swedish Pastry | Real Book Vol 1 - Orig
The Days Of Wine And Rose | The Days Of Wine And Roses | Real Book Vol 1 - Orig
The Disguise The Sphinx | The Disguise | Real Book Vol 1 - Orig
The Shasow Of Your Smile | The Shadow Of Your Smile | Real Book Vol 1 - Orig
The Sorceror | The Sorcerer | Real Book Vol 1 - Orig
There Is No Greatest Love | There Is No Greater Love | Real Book Vol 1 - Orig
Tones For Joans Bones | Tones For Joan's Bones | Real Book Vol 1 - Orig
Tune Up | Tune-Up | Real Book Vol 1 - Orig
Waltz For Derby | Waltz For Debby | Real Book Vol 1 - Orig
What Are You Doing The Rest Of Your Life? | What Are You Doing The Rest Of Your Life | Real Book Vol 1 - Orig
What Is This Thing Love | What Is This Thing Called Love | Real Book Vol 1 - Orig
Where Are You? | Where Are You | Real Book Vol 1 - Orig
Wildflower | Wild Flower | Real Book Vol 1 - Orig
Woody 'N' You | Woody'n You | Real Book Vol 1 - Orig
Round Midnight | 'Round Midnight | Real Book Vol 1 - Orig
Five Hundred Miles High | 500 Miles High | Real Book Vol 1 - Orig
Sey40R Mouse | Senor Mouse | Real Book Vol 1 - Orig
More I See You(The) | The More I See You | Real Book Vol 1 - Orig
Hullo Bolinas | Hello, Bolinas | Real Book Vol 1 - Orig
Hullo, Bolinas | Hello, Bolinas | Real Book Vol 1 - Orig
I Let A Song | I Let A Song (Go Out Of My Heart) | Real Book Vol 1 - Orig
Bag's Groove | Bags' Groove | Real Book Vol 2 - Orig
Bills' Hit Tune | Bill's Hit Tune | Real Book Vol 2 - Orig
Blues Ala Mode | Blue A La Mode | Real Book Vol 2 - Orig
Bewitched Bothered And Bewildered | Bewitched, Bothered And Bewildered | 557 Jazz Standards Swing to Pop - Unknown
I'm Gonna Sit Right Down And Write Myself | I'm Gonna Sit Right Down And Write Myself A Letter | Jazz Fake Book - Unknown
Hocus Pocus | Hocus-Pocus | Real Book Vol 2 - Orig
Adams Apple | Adam's Apple | Jazz Ltd - Over 500 Tunes the Real Book Missed - Unknown
Aguardiente De Calla | Aguardiente De Cana | Latin Real Book - Chuck Sher
Aggravatin' Papa / Don't You Try To Two-Time Me | Aggravatin' Papa (Don't You Try To Two-Time Me) | Firehouse Jazz Band - Unknown
All The Girls Go Crazy 'Bout The Way I Walk | All The Girls Go Crazy 'Bout The Way I Walk (All The Whores Like The Way I Ride) | Firehouse Jazz Band - Unknown
Bemba Colord | Bemba Colora | Latin Real Book - Chuck Sher
Simple Matter Of Conviction | A Simple Matter Of Conviction | Bill Evans Fake Book - Hal Leonard
I'm Gonna Sit Right Down And Write Myself | I'm Gonna Sit Right Down And Write Myself A Letter | Jazz Fake Book - Unknown
Crystal | Crystal Love | New Real Book Vol 1 - Chuck Sher
Endangered Species (Shorter) | Endangered Species | New Real Book Vol 1 - Chuck Sher
Certain Smile | A Certain Smile | Real Book Vol 3 - Orig
Afghanistan / A Romance Of Asia | Afghanistan (A Romance Of Asia) | Firehouse Jazz Band - Unknown
Aggravatin' Papa / Don't You Try To Two-Time Me | Aggravatin' Papa (Don't You Try To Two-Time Me) | Firehouse Jazz Band - Unknown
All The Girls Go Crazy 'Bout The Way I Walk (All The Whores Like The Way I Ride) | All The Girls Go Crazy 'Bout The Way I Walk | Firehouse Jazz Band - Unknown
Atlanta Blues / Make Me One Pallet On Your Floor | Atlanta Blues (Make Me One Pallet On Your Floor) | Firehouse Jazz Band - Unknown
Aun't Hagar's Blues | Aun't Hagar's Blues (Aun't Hagar's Children Blues) | Firehouse Jazz Band - Unknown
Black Bottom Stomp / Queen Of Spades | Black Bottom Stomp (The) (Queen Of Spades) | Firehouse Jazz Band - Unknown
Ble And Broken-Hearted | Ble (And Broken-Hearted) | Firehouse Jazz Band - Unknown
Buddy Bolden Blues / Funky Butt | Buddy Bolden Blues (Funky Butt) | Firehouse Jazz Band - Unknown
A Cottage For Salt | A Cottage For Sale | Ultimate Jazz Fake Book - Hal Leonard
Night In Tunisia | A Night In Tunisia | Ultimate Jazz Fake Book - Hal Leonard
Alright Okay You Win | Alright, Okay, You Win | Ultimate Jazz Fake Book - Hal Leonard
Among My Souvenirs | Among My Souveniers | Ultimate Jazz Fake Book - Hal Leonard
Bag's Groove | Bags' Groove | Ultimate Jazz Fake Book - Hal Leonard
Bag's New Groove | Bags' New Groove | Ultimate Jazz Fake Book - Hal Leonard
Boogie Woogie (The Original) | Boogie Woogie | Ultimate Jazz Fake Book - Hal Leonard
Boplicity | Boplicity (Bebop Lives) | Ultimate Jazz Fake Book - Hal Leonard
C. C. Rider | C.C. Rider | Ultimate Jazz Fake Book - Hal Leonard
Cherokee | Cherokee (Indian Love Song) | Ultimate Jazz Fake Book - Hal Leonard
Choo Choo Ch'boogie | Choo Choo Ch' Boogie | Ultimate Jazz Fake Book - Hal Leonard
Desafinado (Slightly Out Of Tune) | Desafinado | Ultimate Jazz Fake Book - Hal Leonard
Do You Know What It Means To Miss New Orleans? | Do You Know What It Means To Miss New Orleans | Ultimate Jazz Fake Book - Hal Leonard
Don't Let The Sun Catch You Crying | Don't Let The Sun Catch You Cryin' | Ultimate Jazz Fake Book - Hal Leonard
East Of The Sun | East Of The Sun (And West Of The Moon) | Ultimate Jazz Fake Book - Hal Leonard
For You For Me For Evermore | For You, For Me, For Evermore | Ultimate Jazz Fake Book - Hal Leonard
Frosty The Snowman | Frosty The Snow Man | Ultimate Jazz Fake Book - Hal Leonard
Gee Baby Ain't I Good To You | Gee Baby, Ain't I Good To You | Ultimate Jazz Fake Book - Hal Leonard
God Bless The Child | God Bless' The Child | Ultimate Jazz Fake Book - Hal Leonard
Hello Dolly! | Hello, Dolly! | Ultimate Jazz Fake Book - Hal Leonard
Hifly | High Fly | Ultimate Jazz Fake Book - Hal Leonard
I Don't Know Why | I Don't Know Why (I Just Do) | Ultimate Jazz Fake Book - Hal Leonard
I Remember When | I Remember When (Si Tu Vois Me Mere) | Ultimate Jazz Fake Book - Hal Leonard
I've Herd That Song Before | I've Heard That Song Before | Ultimate Jazz Fake Book - Hal Leonard
In A Shanty In. Old Shanty Town | In A Shanty In Old Shanty Town | Ultimate Jazz Fake Book - Hal Leonard
Is You Is, Or Is You Ain't (Ma' Baby) | Is You Is Or Is You Ain't | Ultimate Jazz Fake Book - Hal Leonard
It's Sand Man | It's Sand, Man | Ultimate Jazz Fake Book - Hal Leonard
Johnny One-Note | Johnny One Note | Ultimate Jazz Fake Book - Hal Leonard
Jordu | Jor Du | Ultimate Jazz Fake Book - Hal Leonard
Little Willie Leaps | Little Willy Leaps | Ultimate Jazz Fake Book - Hal Leonard
Mad About Him, Sad About Him, How Can I Be | Mad About Him Sad Without Him | Ultimate Jazz Fake Book - Hal Leonard
Mercy Mercy Mercy | Mercy, Mercy, Mercy | Ultimate Jazz Fake Book - Hal Leonard
Merry Christmas Baby | Merry Christmas, Baby | Ultimate Jazz Fake Book - Hal Leonard
Moonlight And Roses | Moonlight And Roses (Bring Mem'ries Of You) | Ultimate Jazz Fake Book - Hal Leonard
Nevertheless (I'm In Love With You)! | Nevertheless (I'm In Love With You) | Ultimate Jazz Fake Book - Hal Leonard
Now He Sings | Now He Sings, Now He Sobs | Ultimate Jazz Fake Book - Hal Leonard
Poinciana | Poinciana (Song Of The Tree) | Ultimate Jazz Fake Book - Hal Leonard
Quiet Nights Of Quiet Stars | Quiet Nights Of Quiet Stars (Corcovado) | Ultimate Jazz Fake Book - Hal Leonard
River | River, Stay 'Way From My Door | Ultimate Jazz Fake Book - Hal Leonard
Ruby | Ruby, My Dear | Ultimate Jazz Fake Book - Hal Leonard
Sentimental Jorney | Sentimental Journey | Ultimate Jazz Fake Book - Hal Leonard
Shake Rattle And Roll | Shake, Rattle And Roll | Ultimate Jazz Fake Book - Hal Leonard
Side By Side) | Side By Side | Ultimate Jazz Fake Book - Hal Leonard
So Nice | So Nice (Sumer Sumamba) | Ultimate Jazz Fake Book - Hal Leonard
Songbird | Songbird (Thank You For Your Lovely Song) | Ultimate Jazz Fake Book - Hal Leonard
Sweet Sue Just You | Sweet Sue - Just You | Ultimate Jazz Fake Book - Hal Leonard
T'ain'T Nobody's Biz-Ness If I Do | T'aint Nobody's Biz-Ness If I Do | Ultimate Jazz Fake Book - Hal Leonard
T'ain'T What You Do (It's The Way That Cha Do It) | T'aint What You Do (It's The Way That Cha Do It) | Ultimate Jazz Fake Book - Hal Leonard
Take The "A" Train | Take The 'A' Train | Ultimate Jazz Fake Book - Hal Leonard
The Breeze And 1 | The Breeze And I | Ultimate Jazz Fake Book - Hal Leonard
The New Frankie And Johnnie Son | The New "Frankie And Johnnie" Song | Ultimate Jazz Fake Book - Hal Leonard
The Tailgate Rumble | The Tailgate Ramble | Ultimate Jazz Fake Book - Hal Leonard
There Are Such Thing | There Are Such Things | Ultimate Jazz Fake Book - Hal Leonard
Too Dam Hot | Too Darn Hot | Ultimate Jazz Fake Book - Hal Leonard
While We Were Young | While We're Young | Ultimate Jazz Fake Book - Hal Leonard
Who Can I Turn To | Who Can I Turn To (When Nobody Needs Me) | Ultimate Jazz Fake Book - Hal Leonard
You Made Me Love You | You Made Me Love You (I Didn't Want To Do It) | Ultimate Jazz Fake Book - Hal Leonard
A Bid For | A Bid For Sid | Jazz Ltd - Over 500 Tunes the Real Book Missed - Unknown
An Oscar For Threadwell | An Oscar For Treadwell | Jazz Ltd - Over 500 Tunes the Real Book Missed - Unknown
Bark For Barksdale | Bark For Barsdale | Jazz Ltd - Over 500 Tunes the Real Book Missed - Unknown
Beakshire Blues | Berkshire Blues | Jazz Ltd - Over 500 Tunes the Real Book Missed - Unknown
Birds Mother | Bird's Mother | Jazz Ltd - Over 500 Tunes the Real Book Missed - Unknown
Bongo Hop | Bongo Bop | Jazz Ltd - Over 500 Tunes the Real Book Missed - Unknown
Cantelope Island | Canteloupe Island | Jazz Ltd - Over 500 Tunes the Real Book Missed - Unknown
Chasin' The Bird | Chasing The Bird | Jazz Ltd - Over 500 Tunes the Real Book Missed - Unknown
Comin Down | Comin' Down | Jazz Ltd - Over 500 Tunes the Real Book Missed - Unknown
Comin' On The Hudson | Coming On The Hudson | Jazz Ltd - Over 500 Tunes the Real Book Missed - Unknown
Comrad Conrad | Comrade Conrad | Jazz Ltd - Over 500 Tunes the Real Book Missed - Unknown
Connies Bounce | Connie's Bounce | Jazz Ltd - Over 500 Tunes the Real Book Missed - Unknown
Crepuscule With Nellis | Crepuscule With Nellie | Jazz Ltd - Over 500 Tunes the Real Book Missed - Unknown
D,J... Vu | Deja Vu | Jazz Ltd - Over 500 Tunes the Real Book Missed - Unknown
Doin' The Things | Doin' The Thing | Jazz Ltd - Over 500 Tunes the Real Book Missed - Unknown
Doodlin | Doodlin' | Jazz Ltd - Over 500 Tunes the Real Book Missed - Unknown
Duke's Sound Of Love | Duke Ellington's Sound Of Love | Jazz Ltd - Over 500 Tunes the Real Book Missed - Unknown
Ein Rein Strauss | Ein Bein Strauss | Jazz Ltd - Over 500 Tunes the Real Book Missed - Unknown
Ericloth | Erlcloth | Jazz Ltd - Over 500 Tunes the Real Book Missed - Unknown
Florences Fantasy | Florence's Fantasy | Jazz Ltd - Over 500 Tunes the Real Book Missed - Unknown
Free Wheeling | Free Wheelin' | Jazz Ltd - Over 500 Tunes the Real Book Missed - Unknown
Fuschia Skiing Song | Fuschia Swing Song | Jazz Ltd - Over 500 Tunes the Real Book Missed - Unknown
Giggin' And Drinkin | Giggin' And Drinkin' | Jazz Ltd - Over 500 Tunes the Real Book Missed - Unknown
Home Stretch | Homestretch | Jazz Ltd - Over 500 Tunes the Real Book Missed - Unknown
Hypochtistmutreefuzz | Hypochristmutreefuzz | Jazz Ltd - Over 500 Tunes the Real Book Missed - Unknown
I Get Along Without You | I Get Along Without You Very Well | Jazz Ltd - Over 500 Tunes the Real Book Missed - Unknown
It Happens Everyday | It Happens Every Day | Jazz Ltd - Over 500 Tunes the Real Book Missed - Unknown
It's You Or No One | It's You Or No One For Me | Jazz Ltd - Over 500 Tunes the Real Book Missed - Unknown
Laurie (The Dream) | Laurie | Jazz Ltd - Over 500 Tunes the Real Book Missed - Unknown
Maidens Of Cadiz | Maids Of Cadiz | Jazz Ltd - Over 500 Tunes the Real Book Missed - Unknown
Miss Ann (I & 2) | Miss Ann | Jazz Ltd - Over 500 Tunes the Real Book Missed - Unknown
Monks Dream | Monk's Dream | Jazz Ltd - Over 500 Tunes the Real Book Missed - Unknown
Nancy (With The Laughing Face) | Nancy With The Laughing Face | Jazz Ltd - Over 500 Tunes the Real Book Missed - Unknown
One For My Baby (And One More For The Road) | One For My Baby | Jazz Ltd - Over 500 Tunes the Real Book Missed - Unknown
Our Man Higgins Man | Our Man Higgins | Jazz Ltd - Over 500 Tunes the Real Book Missed - Unknown
Pats New Samba | Pat's New Samba | Jazz Ltd - Over 500 Tunes the Real Book Missed - Unknown
Quartet No.2 Part 2 | Quartet No. 2 Part 2 | Jazz Ltd - Over 500 Tunes the Real Book Missed - Unknown
Rapuzel | Rapunzel | Jazz Ltd - Over 500 Tunes the Real Book Missed - Unknown
Receipt Please | Receipt, Please | Jazz Ltd - Over 500 Tunes the Real Book Missed - Unknown
Richards Tune | Richard's Tune | Jazz Ltd - Over 500 Tunes the Real Book Missed - Unknown
Scourn' | Scour'n | Jazz Ltd - Over 500 Tunes the Real Book Missed - Unknown
Sid's Ahead (Weirdo) | Sid's Ahead | Jazz Ltd - Over 500 Tunes the Real Book Missed - Unknown
Dj Vu | Deja Vu | Jazz Ltd - Over 500 Tunes the Real Book Missed - Unknown
So Near So Far | So Near, So Far | Jazz Ltd - Over 500 Tunes the Real Book Missed - Unknown
Stockholm Sweetnin | Stockholm Sweetin' | Jazz Ltd - Over 500 Tunes the Real Book Missed - Unknown
Straight Up And Down (Corea) | Straight Up And Down | Jazz Ltd - Over 500 Tunes the Real Book Missed - Unknown
Sues Changes | Sue's Changes | Jazz Ltd - Over 500 Tunes the Real Book Missed - Unknown
That Art,He's All Heart | That Artt He's All Heart | Jazz Ltd - Over 500 Tunes the Real Book Missed - Unknown
That's Earl Brother | That's Earl, Brother | Jazz Ltd - Over 500 Tunes the Real Book Missed - Unknown
Thumb The) | The Thumb | Jazz Ltd - Over 500 Tunes the Real Book Missed - Unknown
Trinkle-Tinkle | Trinkle Tinkle | Jazz Ltd - Over 500 Tunes the Real Book Missed - Unknown
Valse Trists | Valse Triste | Jazz Ltd - Over 500 Tunes the Real Book Missed - Unknown
Vonetta (Earl Klugh) | Vonetta | Jazz Ltd - Over 500 Tunes the Real Book Missed - Unknown
Wait Till Forever | Wait Until Forever | Jazz Ltd - Over 500 Tunes the Real Book Missed - Unknown
When You Meet Here | When You Meet Her | Jazz Ltd - Over 500 Tunes the Real Book Missed - Unknown
Where You | Where You At | Jazz Ltd - Over 500 Tunes the Real Book Missed - Unknown
Yearnin | Yearnin' | Jazz Ltd - Over 500 Tunes the Real Book Missed - Unknown
A Parisian Thoroughfare | Parisian Thoroughfare | Jazz Ltd - Over 500 Tunes the Real Book Missed - Unknown
Sunday Kind Of Love | A Sunday Kind Of Love | Jazz Ltd - Over 500 Tunes the Real Book Missed - Unknown
Where You At | Where You At? | Jazz Ltd - Over 500 Tunes the Real Book Missed - Unknown
I Could A Book | I Could Write A Book | Jazz Fake Book - Unknown
Ain't Misbehavin | Ain't Misbehavin' | New Real Book Vol 2 - Chuck Sher
Asa | Asa (The Zoo Blues) | New Real Book Vol 2 - Chuck Sher
Baby It's Cold Outside | Baby, It's Cold Outside | New Real Book Vol 2 - Chuck Sher
Chromozone | Chromazone | New Real Book Vol 2 - Chuck Sher
Devil May Cape | Devil May Care | New Real Book Vol 2 - Chuck Sher
Friday Night At The Cadellac Club | Friday Night At The Cadillac Club | New Real Book Vol 2 - Chuck Sher
Got A Match | Got A Match? | New Real Book Vol 2 - Chuck Sher
Hi Fly | Hi-Fly | New Real Book Vol 2 - Chuck Sher
Horacescope | Horace Scope | New Real Book Vol 2 - Chuck Sher
I Thought About You (Latin-Funk) | I Thought About You | New Real Book Vol 2 - Chuck Sher
Illuninados | Illuminados | New Real Book Vol 2 - Chuck Sher
It's Tim Talk Of The Town | It's The Talk Of The Town | New Real Book Vol 2 - Chuck Sher
Like A Lover | Like A Lover (O Cantador) | New Real Book Vol 2 - Chuck Sher
Like Father Like Son | Like Father, Like Son | New Real Book Vol 2 - Chuck Sher
Manha De Carneval | Manha De Carnaval | New Real Book Vol 2 - Chuck Sher
Naima (Niema) | Naima | New Real Book Vol 2 - Chuck Sher
Nightmood (Leinbra) | Nightmood | New Real Book Vol 2 - Chuck Sher
Ode To Tee Doo Da Day | Ode To The Doo Da Day | New Real Book Vol 2 - Chuck Sher
Seaven Steps To Heaven | Seven Steps To Heaven | New Real Book Vol 2 - Chuck Sher
Stardust | Star Dust | New Real Book Vol 2 - Chuck Sher
Strollin | Strollin' | New Real Book Vol 2 - Chuck Sher
T. B. C. | T.B.C. (Terminal Baggage Claim) | New Real Book Vol 2 - Chuck Sher
The Joint Is Jumpin | The Joint Is Jumpin' | New Real Book Vol 2 - Chuck Sher
Til There Was You | Till There Was You | New Real Book Vol 2 - Chuck Sher
Time Tracks | Time Track | New Real Book Vol 2 - Chuck Sher
Tristeza (Goodbye Sadness) | Tristeza | New Real Book Vol 2 - Chuck Sher
Unforgetable | Unforgettable | New Real Book Vol 2 - Chuck Sher
Unless It's You | Unless It's You (Orbit) | New Real Book Vol 2 - Chuck Sher
Unless It's You (Aka Orbit) | Unless It's You (Orbit) | New Real Book Vol 2 - Chuck Sher
Unless Its You (Orbit) | Unless It's You (Orbit) | New Real Book Vol 2 - Chuck Sher
Velho Plano | Velho Piano | New Real Book Vol 2 - Chuck Sher
What A Diffrence A Day Made | What A Difference A Day Made | New Real Book Vol 2 - Chuck Sher
Whenever Your Heart Want's To Sing | Whenever Your Heart Wants To Sing | New Real Book Vol 2 - Chuck Sher
Whenver Your Heart Wants To Sing | Whenever Your Heart Wants To Sing | New Real Book Vol 2 - Chuck Sher
Will You Still Be Mine | Will You Still Be Mine? | New Real Book Vol 2 - Chuck Sher
Woody'n You | Woody 'N You | New Real Book Vol 2 - Chuck Sher
Woody'n You | Woody 'N You | New Real Book Vol 2 - Chuck Sher
Woody'n You (Algo Bueno) | Woody 'N You | New Real Book Vol 2 - Chuck Sher
Woodyn' You | Woody 'N You | New Real Book Vol 2 - Chuck Sher
