12Th Street Rag | The 12Th Street Rag
Ace In The Hole | The Ace In The Hole
Alley Cat Song | The Alley Cat Song
American Patrol | The American Patrol
Anniversary Waltz | The Anniversary Waltz
Artist's Life | The Artist's Life
Babe | The Babe
Bagdad Blues | The Bagdad Blues
Ballad Of Davy Crockett | The Ballad Of Davy Crockett
Ballad Of Gilligan's Isle | The Ballad Of Gilligan's Isle
Banana Boat Song | The Banana Boat Song
Basin Street Blues | The Basin Street Blues
Battle Hymn Of The Republic | The Battle Hymn Of The Republic
Battle Of New Orleans | The Battle Of New Orleans
Best Is Yet To Come | The Best Is Yet To Come
Best Of My Love | The Best Of My Love
Best Thing For You | The Best Thing For You
Best Thing You've Ever Done | The Best Thing You've Ever Done
Best Things In Life Are Free | The Best Things In Life Are Free
Big Push | The Big Push
Birth Of The Blues | The Birth Of The Blues
Blue Room | The Blue Room
Blue Skirt Waltz | The Blue Skirt Waltz
Blues | The Blues
Blues Walk | The Blues Walk
Boulevard Of Broken Dreams | The Boulevard Of Broken Dreams
Boy Next Door | The Boy Next Door
Boys Are Back In Town | The Boys Are Back In Town
Breakthrough | The Breakthrough
Breeze And I | The Breeze And I
Broadway Melody | The Broadway Melody
Bugle Call Rag | The Bugle Call Rag
Bunny Hop | The Bunny Hop
Calypso | The Calypso
Carioca | The Carioca
Cat Walk | The Cat Walk
Champ | The Champ
Charleston | The Charleston
Christmas Song | The Christmas Song
Closer I Get To You | The Closer I Get To You
Continental | The Continental
Cornerstone | The Cornerstone
Coventry Carol | The Coventry Carol
Creole Love Call | The Creole Love Call
Cruel War | The Cruel War
Curse Of An Aching Heart | The Curse Of An Aching Heart
Darktown Strutter's Ball | The Darktown Strutter's Ball
Darktown Strutters Ball | The Darktown Strutters Ball
Daughter Of Peggy O'neil | The Daughter Of Peggy O'neil
Daughter Of Rosie O'grady | The Daughter Of Rosie O'grady
Day You Came Along | The Day You Came Along
Days Of Wine And Roses | The Days Of Wine And Roses
Doll Dance | The Doll Dance
Donkey Serenade | The Donkey Serenade
Down Home Rag | The Down Home Rag
Drive | The Drive
Duke | The Duke
Enchanted Sea | The Enchanted Sea
End | The End
End Of The World | The End Of The World
Erie Canal | The Erie Canal
Eternal Triangle | The Eternal Triangle
Evening Star | The Evening Star
Exodus Song | The Exodus Song
Eyes Of Texas | The Eyes Of Texas
Farmer In The Dell | The Farmer In The Dell
First Cut Is The Deepest | The First Cut Is The Deepest
Flat Foot Floogie | The Flat Foot Floogie
Flintstones | The Flintstones
Folks Who Live On The Hill | The Folks Who Live On The Hill
Fool On The Hill | The Fool On The Hill
Four Winds | The Four Winds
Foxhorn Song | The Foxhorn Song
Funky Fox | The Funky Fox
Game Of Love | The Game Of Love
Gentle Rain | The Gentle Rain
Girl | The Girl
Girl From Ipanema | The Girl From Ipanema
Girl In My Dreams Tries To Look Like You | The Girl In My Dreams Tries To Look Like You
Girl That I Marry | The Girl That I Marry
Girl Who Used To Be Me | The Girl Who Used To Be Me
Glory Of Love | The Glory Of Love
Glow Worm | The Glow Worm
Great Speckled Bird | The Great Speckled Bird
Greatest Gift Of All | The Greatest Gift Of All
Greatest Love Of All | The Greatest Love Of All
Greatest Performance Of My Life | The Greatest Performance Of My Life
Greatest Show On Earth | The Greatest Show On Earth
Green Leaves Of Summer | The Green Leaves Of Summer
Greene St. Caper | The Greene St. Caper
Grizzly Bear Rag | The Grizzly Bear Rag
Gypsy In My Soul | The Gypsy In My Soul
Hands Of Time | The Hands Of Time
Happy Wanderer | The Happy Wanderer
Hawaiian Wedding Song | The Hawaiian Wedding Song
Heather On The Hill | The Heather On The Hill
Hesitating Blues | The Hesitating Blues
High And The Mighty | The High And The Mighty
Hokey Pokey | The Hokey Pokey
Holy Child | The Holy Child
Homecoming | The Homecoming
House Of The Rising Sun | The House Of The Rising Sun
Inchworm | The Inchworm
Intrepid Fox | The Intrepid Fox
Invisible | The Invisible
Irish Washerwoman | The Irish Washerwoman
Island | The Island
Isle Of Capri | The Isle Of Capri
James Bond Theme | The James Bond Theme
Japanese Farewell Song | The Japanese Farewell Song
Japanese Sandman | The Japanese Sandman
Jazz Me Blues | The Jazz Me Blues
Jelly Roll Blues | The Jelly Roll Blues
Jitterbug Waltz | The Jitterbug Waltz
Jive Samba | The Jive Samba
Jody Grind | The Jody Grind
Joint Is Jumpin' | The Joint Is Jumpin'
Journey To The Heavyside Layer | The Journey To The Heavyside Layer
Juggernaut | The Juggernaut
Kerry Dance | The Kerry Dance
King Porter Stomp | The King Porter Stomp
Kiss Waltz | The Kiss Waltz
Lady In Red | The Lady In Red
Lady Sings The Blues | The Lady Sings The Blues
Last Time I Saw Paris | The Last Time I Saw Paris
Last Word In Lonesome Is Me | The Last Word In Lonesome Is Me
Little Brown Jug | The Little Brown Jug
Lonely Goatherd | The Lonely Goatherd
Lonesome Road | The Lonesome Road
Look Of Love | The Look Of Love
Lorelei | The Lorelei
Love Connection | The Love Connection
Love Nest | The Love Nest
Loveliest Night Of The Year | The Loveliest Night Of The Year
Man I Love | The Man I Love
Man On The Flying Trapeeze | The Man On The Flying Trapeeze
Man Who Shot Liberty Valance | The Man Who Shot Liberty Valance
Man With A Horn | The Man With A Horn
Maple Leaf Rag | The Maple Leaf Rag
March Of The Siamese Children | The March Of The Siamese Children
Marine's Hymn | The Marine's Hymn
Masquerade Is Over | The Masquerade Is Over
Masterpiece | The Masterpiece
Meeting | The Meeting
Memphis Blues | The Memphis Blues
Merry Christmas Polka | The Merry Christmas Polka
Merry Widow Waltz | The Merry Widow Waltz
Merry-Go-Round | The Merry-Go-Round
Mickey Mouse March | The Mickey Mouse March
Midgets | The Midgets
Midnight Special | The Midnight Special
Midnight Sun | The Midnight Sun
Midnight Sun Will Never Set | The Midnight Sun Will Never Set
Minstrel Boy | The Minstrel Boy
Missing Link | The Missing Link
Missouri Waltz | The Missouri Waltz
More I See You | The More I See You
Moten Swing | The Moten Swing
Mulberry Bush | The Mulberry Bush
Muppet Show Theme | The Muppet Show Theme
Music Goes 'Round And Around | The Music Goes 'Round And Around
Naked Gun From The Files Of Police Squad! | The Naked Gun From The Files Of Police Squad!
Naughty Lady Of Shady Lane | The Naughty Lady Of Shady Lane
Nearness Of You | The Nearness Of You
Next Time It Happens | The Next Time It Happens
Night Before Christmas Song | The Night Before Christmas Song
Night Has A Thousand Eyes | The Night Has A Thousand Eyes
Night They Invented Champagne | The Night They Invented Champagne
Night We Called It A Day | The Night We Called It A Day
Object Of My Affection | The Object Of My Affection
Old Chisholm Trail | The Old Chisholm Trail
Old Country | The Old Country
Old Folks At Home | The Old Folks At Home
Old Oaken Bucket | The Old Oaken Bucket
Old Rugged Cross | The Old Rugged Cross
Organ Grinder | The Organ Grinder
Original Dixieland One-Step | The Original Dixieland One-Step
Other Man's Grass Is Always Greener | The Other Man's Grass Is Always Greener
Parade Of The Wooden Soldiers | The Parade Of The Wooden Soldiers
Party's Over | The Party's Over
Patty Duke Theme | The Patty Duke Theme
Paw-Paw Patch | The Paw-Paw Patch
Peanut Vendor | The Peanut Vendor
Pearls | The Pearls
People In Me | The People In Me
Point Of No Return | The Point Of No Return
Poor People Of Paris | The Poor People Of Paris
Power Of Love | The Power Of Love
Pretty Girl Milking Her Cow | The Pretty Girl Milking Her Cow
Promise | The Promise
Quilting Party | The Quilting Party
Real American Folk Song (Is A Rag) | The Real American Folk Song (Is A Rag)
Real Guitarist | The Real Guitarist
Real Thing | The Real Thing
Red Door | The Red Door
Risin' Sun | The Risin' Sun
Riviera | The Riviera
Rock Island Line | The Rock Island Line
Rose | The Rose
Rose In Her Hair | The Rose In Her Hair
Rose Of Tralee | The Rose Of Tralee
Rules Of The Road | The Rules Of The Road
Second Time Around | The Second Time Around
September Of My Years | The September Of My Years
Serpent's Tooth | The Serpent's Tooth
Seventh Son | The Seventh Son
Shadow Of Your Smile | The Shadow Of Your Smile
Sheik Of Araby | The Sheik Of Araby
Sidewalks Of New York | The Sidewalks Of New York
Sidewinder | The Sidewinder
Single Petal Of A Rose | The Single Petal Of A Rose
Sixth Sense | The Sixth Sense
Skater's Waltz | The Skater's Waltz
Snapper | The Snapper
Soldiers Of The Queen | The Soldiers Of The Queen
Son Of A Gambolier | The Son Of A Gambolier
Song Is You | The Song Is You
Song Of Norway | The Song Of Norway
Sophisticated Hippie | The Sophisticated Hippie
Sorcerer | The Sorcerer
Sound Of Music | The Sound Of Music
Squirrel | The Squirrel
Star Spangled Banner | The Star Spangled Banner
Star-Crossed Lovers | The Star-Crossed Lovers
Stars And Stripes Forever | The Stars And Stripes Forever
Story | The Story
Storyville Blues | The Storyville Blues
Straight Life | The Straight Life
Stranger | The Stranger
Streets Of Laredo | The Streets Of Laredo
Streets Of London | The Streets Of London
Strenuous Life | The Strenuous Life
Stripper | The Stripper
Stroll | The Stroll
Sugar Blues | The Sugar Blues
Summer Knows | The Summer Knows
Summer Wind | The Summer Wind
Sunshine Of Your Love | The Sunshine Of Your Love
Surrey With The Fringe On Top | The Surrey With The Fringe On Top
Sweetest Sounds | The Sweetest Sounds
Sweetheart Of Sigma Chi | The Sweetheart Of Sigma Chi
Swingin' Shepherd Blues | The Swingin' Shepherd Blues
Syncopated Clock | The Syncopated Clock
Tailgate Ramble | The Tailgate Ramble
Tender Trap | The Tender Trap
The Touch Of Your Lips | The The Touch Of Your Lips
Theme | The Theme
Things We Did Last Summer | The Things We Did Last Summer
Third Man Theme | The Third Man Theme
Thunderer | The Thunderer
Tickle Toe | The Tickle Toe
Tiger Rag | The Tiger Rag
Tin Roof Blues | The Tin Roof Blues
Tokyo Blues | The Tokyo Blues
Touch Of Your Hand | The Touch Of Your Hand
Tracks Of My Tears | The Tracks Of My Tears
Twelfth Of Never | The Twelfth Of Never
Twelve Days Of Christmas | The Twelve Days Of Christmas
Two Of Us | The Two Of Us
Varsity Drag | The Varsity Drag
Very Thought Of You | The Very Thought Of You
Wabash Blues | The Wabash Blues
Wabash Cannon Ball | The Wabash Cannon Ball
Wah-Watusi | The Wah-Watusi
Wang Wang Blues | The Wang Wang Blues
Washington Post March | The Washington Post March
Washington Twist | The Washington Twist
Way We Were | The Way We Were
Way You Look Tonight | The Way You Look Tonight
Wayfaring Stranger | The Wayfaring Stranger
Wayward Wind | The Wayward Wind
Wearing Of The Green | The Wearing Of The Green
White Cliffs Of Dover | The White Cliffs Of Dover
Wild Side Of Life | The Wild Side Of Life
Wind Beneath My Wings | The Wind Beneath My Wings
Windows Of The World | The Windows Of The World
Wonderful World Of Christmas | The Wonderful World Of Christmas
World Is Waiting For The Sunrise | The World Is Waiting For The Sunrise
Worst That Could Happen | The Worst That Could Happen
Yama Yama Man | The Yama Yama Man
Yankee Doodle Boy | The Yankee Doodle Boy
Yellow Dog Blues | The Yellow Dog Blues
Yellow Rose Of Texas | The Yellow Rose Of Texas
